####################
#                  #
#                  #
#                  #
#                  #
#                  #
#                  #
######### ########## 
        # #
        # #
        # #
        # #         
        # #       
        # #   ###############
        # #   #             #
        # #   #             #
        # #   #             #
        # #   #             #
        # #####             #
        #                   #
        #####################
-
